111111111111111111111111111111111111111111111
100000111110000000000000000000011111111111111
100200111110000000000000000000011111111111111
100000111110000000000000000000011111111111111
100000111110000000000000000000011111111111111
100000111110000000000000000000011111111111111
100000111110000011111111110000011111111111111
100000111110000011111111110000011111111111111
100000111110000011111111110000011111111111111
100000111110000011111111110000011111111111111
100000111110000011111111110000011111111111111
100000111110000011111111110000011111111111111
100000111110000011111111110000011111111111111
100000111110000011111111110000011111111111111
100000111110000011111111110000011111111111111
100000111110000011111111110000011111111111111
100000111110000011111111110000011111111111111
100000111110000011111111110000011111111111111
100000111110000011111111110000011111111111111
100000000000000011111111110000000000000000001
100000000000000011111111110000000000000000001
100000000000000011111111110000000000000000301
100000000000000011111111110000000000000000001
100000000000000011111111110000000000000000001
111111111111111111111111111111111111111111111
