111111111111111111111111111111111111111111111
100100000000000000000000000000000000000000001
100000000000000000000000000000000000000000001
100000000000000000000000000000000000000030001
100000000000000000000000000000000000000000001
100000000000000000000000000000000000000000001
100000000000000000000000000000000000000000001
100000000000000000000000000000000000000000001
100000000000000000000000000000000000000000001
100000000000000000000000000000000000000000001
100000000000000000000000000000000000000000001
100000000000000000000000000000000000000000001
100000000000000000000000000000000000000000001
100000000000000000000000000000000000000000001
100000000000000000000000000000000000000000001
100000000000000000000000000000000000000000001
100000000000000000000000000000001111011111111
100000000000000000000000000000001000000000001
100000000000000000000000000000001000000000001
100000000000000000000000000000001000000000001
100000000000000000000000000000001000000000001
100000000000000000000000000000001007007004041
100000000000000000000000000000001000000000001
100000000000000000000000000000001000000000001
111111111111111111111111111111111111111111111
